..IBBBBBBBBBBBBBBBBBBI..
...IBBBBBBBBBBBBBBBBI...
I...IBBBBBBBBBBBBBBI...I
BI....................IB
BBI.BBBBBBIIIIBBBBBB.IBB
BBB.BBBBBBBBBBBBBBBB.BBB
BBB.BBBBBBBBBBBBBBBB.BBB
BBB.BBBBBBBBBBBBBBBB.BBB
BBB.BBBBBBBBBBBBBBBB.BBB
BBB.BBBBBBBBBBBBBBBB.BBB
BBB.IBBBBBBBBBBBBBBI.BBB
BBB.IBBBBBBBBBBBBBBI.BBB
BBB.IBBBBBBBBBBBBBBI.BBB
BBB.IBBBBBBBBBBBBBBI.BBB
BBB.BBBBBBBBBBBBBBBB.BBB
BBB.BBBBBBBBBBBBBBBB.BBB
BBB.BBBBBBBBBBBBBBBB.BBB
BBB.BBBBBBBBBBBBBBBB.BBB
BBB.BBBBBBBBBBBBBBBB.BBB
BBB.BBBBBBIIIIBBBBBB.BBB
BB....................BB
B...IBBBBBBBBBBBBBBI...B
...IBBBBBBBBBBBBBBBBI...
..IBBBBBBBBBBBBBBBBBBI..
