..BBB.IBBI.BBB..
.BIII.BBBB.IIIB.
BI...I....I...IB
BI.IBIIBBIIIIBIB
BI.I.IBBBBI.I.IB
.I.I.IBIIBI.I.I.
.I.I.IBBBBI.I.I.
.B.B.IIBBII.B.B.
.B.B.IIBBII.B.B.
.I.I.IBBBBI.I.I.
.I.I.IBIIBI.I.I.
BI.I.IBBBBI.I.IB
BI.IBIIBBIIIIBIB
BI...I....I...IB
.BIIIBBBBBBIIIB.
..BBBBIBBIBBBB..