..B...IBBI...B..
.BIII.BBBB.IIIB.
BI...I....I...IB
.IBIBIIBBIIBIBI.
.IBIBIBBBBIBIBI.
.IBIBIBIIBIBIBI.
.IBIBIBBBBIBIBI.
.BBBBIIBBIIBBBB.
.BBBBIIBBIIBBBB.
.IBIBIBBBBIBIBI.
.IBIBIBIIBIBIBI.
.IBIBIBBBBIBIBI.
.IBIBIIBBIIBIBI.
BI...I....I...IB
.BIIIBBBBBBIIIB.
..B...IBBI...B..