.......................
.......................
.......................
.......................
.......................
.......................
.......................
.......................
.......................
...BBBBBBBBBBBBBBBBB...
...IIIIIIIIIIIIIIIII...
...BBBBBBBBBBBBBBBBB...
.......................
.......................
.......................
.......................
.......................
.......................
.......................
.......................
.......................
.......................
.......................
.......................